Map Dimensions
17 10
Map Content
E E E E LFL DF DFL DF LF E E E LFL DF DF DF LF
LF DF DF DF LFL E L E LF DF DFL DF LFL E E E E
E E E E LFL DF DFL DF LFL E L E LFL DF DF DF LF
LF DF DF DF LFL E L E LFL DF DFL DF LFL E E E E
E E E E LFL DF DFL DF LFL E E E LFL DF DF DF LF
LF DF DF DF LFL E E E LFL DF DFL DF LFL E E E LF
E E E E LFL DF DFL DF LFL E L E LFL DF DF DF LF
LF DF DF DF LFL E L E LFL DF DFL DF LFL E E E E
E E E E LFL DF DFL DF LFL E L E LFL DF DF DF LF
LF DF DF DF LFL E E E LFL DF DFL DF LFL E E E E
